Barbarian Attack=Купцы и варвары (сценарий Нашествие варваров)
Base=Базовая игра
Cities & Knights=Города и рыцари
Seafarers=Мореходы
The Fishermen of Catan=Купцы и варвары (сценарий Рыбаки катана)
Traders & Barbarians=Купцы и варвары (сценарий Купцы и варвары)
Byzantines=Византийцы
Cumans=Половцы
Franks=Франки
Goths=Готы
Tatars=Татары
Aztecs=Ацтеки
Britons=Британцы
Chinese=Китайцы
Ethiopians=Эфиопы
Gurjaras=Гурджары
Huns=Гунны
Incas=Инки
Japanese=Японцы
Khmer=Кхмеры
Lithuanians=Литовцы
Magyars=Mадьяры
Malays=Малайцы
Mongols=Монголы
Persians=Персы
Spanish=Испанцы
Vietnamese=Вьетнамцы
Vikings=Викинги
Berbers=Берберы
Burgundians=Бургундцы
Burmese=Бирманцы
Hindustanis=Хиндустанцы
Malians=Малийцы
Mayans=Майя
Poles=Поляки
Portugese=Португальцы
Romans=Римляне
Saracens=Сарацины
Sicilians=Сицилийцы
Teutons=Тевтоны
Turks=Турки
Italians=Итальянцы
Dravidians=Дравиды
Bengalis=Бенгальцы
Bohemians=Богемцы
Bulgarians=Болгары
Celts=Кельты
Koreans=Корейцы
Slavs=Славяне
